const unsigned short castle[] = {
 0x07E0, 0x07E0, 0x07E0, 0x07E0, 0x07E0, 0x07E0, 0x07E0, 0x07E0, 0x07E0, 0x07E0, 0x07E0, 0x07E0, 0x07E0, 0x07E0, 0x07E0, 0x07E0,
 0x07E0, 0x07E0, 0x07E0, 0x07E0, 0x07E0, 0x07E0, 0x07E0, 0x07E0, 0x07E0, 0x07E0, 0x07E0, 0x07E0, 0x07E0, 0x07E0, 0x07E0, 0x07E0,
 0x07E0, 0x07E0, 0x07E0, 0x8DBA, 0x8DBA, 0x8DBA, 0x8DBA, 0x07E0, 0x07E0, 0x07E0, 0x8DBA, 0x8DBA, 0x8DBA, 0x8DBA, 0x07E0, 0x07E0,
 0x07E0, 0x07E0, 0x8DBA, 0x8DBA, 0xF800, 0xF800, 0xF800, 0xAD55, 0xAD55, 0xAD55, 0xF800, 0xF800, 0xF800, 0x8DBA, 0x8DBA, 0x07E0,
 0x07E0, 0x8DBA, 0x8DBA, 0xF800, 0xF800, 0xF800, 0xF800, 0xAD55, 0xAD55, 0xAD55, 0xF800, 0xF800, 0xF800, 0xF800, 0x8DBA, 0x8DBA,
 0x07E0, 0x8DBA, 0xF800, 0xF800, 0xF800, 0xF800, 0xF800, 0xAD55, 0xAD55, 0xAD55, 0xF800, 0xF800, 0xF800, 0xF800, 0xF800, 0x8DBA,
 0x07E0, 0x8DBA, 0xF800, 0xF800, 0xF800, 0xF800, 0xF800, 0xAD55, 0xAD55, 0xAD55, 0xF800, 0xF800, 0xF800, 0xF800, 0xF800, 0x8DBA,
 0x07E0, 0x8DBA, 0xF800, 0x0000, 0x0000, 0x0000, 0x0000, 0x220C, 0x220C, 0x220C, 0x0000, 0x0000, 0x0000, 0x0000, 0xF800, 0x8DBA,
 0x07E0, 0x8DBA, 0xF800, 0x0000, 0x0000, 0x0000, 0x0000, 0x220C, 0x220C, 0x220C, 0x0000, 0x0000, 0x0000, 0x0000, 0xF800, 0x8DBA,
 0x07E0, 0x8DBA, 0xF800, 0x0000, 0x0000, 0x0000, 0x0000, 0x220C, 0x220C, 0x220C, 0x0000, 0x0000, 0x0000, 0x0000, 0xF800, 0x8DBA,
 0x07E0, 0x8DBA, 0x8DBA, 0x0000, 0x0000, 0x0000, 0x0000, 0x0000, 0x0000, 0x0000, 0x0000, 0x0000, 0x0000, 0x0000, 0x8DBA, 0x8DBA,
 0x07E0, 0x07E0, 0x8DBA, 0x0000, 0x0000, 0x0000, 0x0000, 0x0000, 0x0000, 0x0000, 0x0000, 0x0000, 0x0000, 0x0000, 0x8DBA, 0x07E0,
 0x07E0, 0x07E0, 0x07E0, 0x0000, 0x0000, 0x0000, 0x0000, 0x0000, 0x0000, 0x0000, 0x0000, 0x0000, 0x0000, 0x0000, 0x07E0, 0x07E0,
 0x07E0, 0x07E0, 0x07E0, 0x0000, 0x07E0, 0x0000, 0x07E0, 0x0000, 0x0000, 0x0000, 0x07E0, 0x0000, 0x07E0, 0x0000, 0x07E0, 0x07E0,
 0x07E0, 0x07E0, 0x07E0, 0x07E0, 0x07E0, 0x07E0, 0x07E0, 0x0000, 0x0000, 0x0000, 0x07E0, 0x07E0, 0x07E0, 0x07E0, 0x07E0, 0x07E0,
 0x07E0, 0x220C, 0x07E0, 0x07E0, 0x07E0, 0x07E0, 0x0000, 0x0000, 0x0000, 0x0000, 0x0000, 0x07E0, 0x07E0, 0x07E0, 0x07E0, 0x07E0,
 0x07E0, 0x07E0, 0x07E0, 0x07E0, 0x07E0, 0x07E0, 0x0000, 0x07E0, 0x0000, 0x07E0, 0x0000, 0x07E0, 0x07E0, 0x07E0, 0x220C, 0x07E0,
 0x07E0, 0x07E0, 0x07E0, 0x07E0, 0x220C, 0x07E0, 0x07E0, 0x07E0, 0x07E0, 0x07E0, 0x07E0, 0x07E0, 0x07E0, 0x07E0, 0x07E0, 0x07E0,
 0x07E0, 0x220C, 0x07E0, 0x07E0, 0x07E0, 0x07E0, 0x07E0, 0x07E0, 0x07E0, 0x07E0, 0x07E0, 0x07E0, 0x220C, 0x07E0, 0x07E0, 0x07E0,
 0x07E0, 0x07E0, 0x07E0, 0x07E0, 0x07E0, 0x07E0, 0x220C, 0x07E0, 0x07E0, 0x07E0, 0x220C, 0x07E0, 0x07E0, 0x07E0, 0x07E0, 0x07E0,

};
